version=1.0
size=19x19
-------------------------------------
  X X X X X X X                      
  X @ X       X X X X   X X X X X X X
  X   X   X         X   X         @ X
  X   X     X X X ~ X X *   X X X X X
  X   X X   X           X   X       X
  X       1 X   X * X   X 2     X   X
  X X * X X X     X     X X X X     X
      X       X       X       X   X X
  X X X   X     X ~ X     X   X   X  
  X   ~   * X   ~ G ~   X *   ~   X  
  X   X   X     X ~ X     X   X X X  
X X   X       X       X       X      
X     X X X X     X     X X X * X X  
X   X     4 X   X * X   X 3       X  
X       X   X           X   X X   X  
X X X X X   * X X ~ X X X     X   X  
X @         X   X         X   X   X  
X X X X X X X   X X X X       X @ X  
                      X X X X X X X  
